neil is a graduate of <MASK> berkeley.	uc
the <MASK> is a burrow 0.	nest
males have a purely reproductive purpose in the <MASK>.	nest
the colonies have a single queen and <MASK> within wood.	nest
below is a list of <MASK> in milan.	museums
the entire route is a <MASK>.	freeway
all members have a relatively high <MASK> inclination.	orbital
the <MASK> have a  concurrency north.	highways
the two <MASK> have a brief unsigned concurrency.	highways
national <MASK> in the province have a total length of 244.	highways
the two <MASK> have a very brief concurrency to the southeast.	highways
the two <MASK> have a brief concurrency to the southeast.	highways
the two <MASK> have a diamond interchange with mt.	highways
the <MASK> ‘have a dream’ from aikatsu!	song
the <MASK> did not have a music video.	song
the <MASK> does not have a true guitar solo.	song
the <MASK> does not have a true guitar solo.	song
is a 1968 song by the <MASK>.	beatles
zeus is a <MASK>.	god
allan is a police <MASK>.	officer
boyle is a police <MASK>.	officer
ajay is a police <MASK>.	officer
tiffany is a police <MASK>.	officer
the film is a psychological <MASK>.	thriller
is a japanese aeronautical engineer and jaxa <MASK>.	astronaut
underwings have a <MASK> band.	white
why does our <MASK> have a basement?	house
mutambara is not a member of the <MASK> of assembly.	house
the film is a black comedy about the aids <MASK>.	epidemic
subsequently there is a cholera <MASK>.	epidemic
a pandemic is a worldwide <MASK>.	epidemic
a <MASK> is a form of civil disorder.	riot
spain does have a <MASK> in tbilisi.	consulate
there is a <MASK> general in haifa.	consulate
there is a <MASK> general in jeddah.	consulate
there is a <MASK> general in busan.	consulate
there is a <MASK> general in annaba.	consulate
there is a <MASK> general in chittagong.	consulate
there is a <MASK> general in gyumri.	consulate
there is a <MASK> general in antwerp.	consulate
there is a <MASK> general in edinburgh.	consulate
there is a russian <MASK> in thiruvananthapuram city.	consulate
there is a <MASK> general in brest.	consulate
hauman is a <MASK> for comicmix.	columnist
1 by <MASK> paganini.	niccolo
zainal is a <MASK> muslim.	sunni
assala is a <MASK> muslim.	sunni
sharif is a <MASK> muslim.	sunni
sara khan is a <MASK> muslim.	sunni
louisiana literature is a <MASK> magazine.	literary
the single did not have a <MASK> video.	music
the song did not have a <MASK> video.	music
there is not a great deal of native italian christmas <MASK>.	music
the irish and <MASK> also have a notable presence.	germans
antimony is not known to have a <MASK> role.	biological
hepatitis is a common condition of <MASK> of the liver.	inflammation
contact dermatitis is a type of <MASK> of the skin.	inflammation
what is a <MASK> election?	presidential
following is a list of <MASK> candidates.	presidential
a king is a male <MASK>.	monarch
china is a country prone to natural <MASK>.	disasters
the <MASK> of liechtenstein is a producer of wine.	principality
superman is a fictional <MASK>.	superhero
on location is a series from <MASK>.	hbo
there is a  boardwalk <MASK> trail.	hiking
banyuls is a centre for <MASK> diving.	scuba
is a <MASK> diving adventure game.	scuba
barata is a titular <MASK> of the catholic church.	bishopric
the caine <MASK> is a 1954 american film.	mutiny
mjnari is a <MASK> with superhuman speed.	mutant
justice is a <MASK> who possesses telekinesis.	mutant
superimposed on the cross is a laurel <MASK>.	wreath
between the arms of the cross is a laurel <MASK>.	wreath
around his head is a <MASK> of oak leaves.	wreath
at the foot of each tablet is a laurel <MASK>.	wreath
visible between the arms of the cross is a laurel <MASK>.	wreath
under the arms of the cross is a laurel <MASK>.	wreath
life is a fairy <MASK>.	tale
reno is a frequent fashion <MASK>.	blogger
asia society is a <MASK> for ideas.	forum
orssa is a <MASK> organization.	nonprofit
the festival is a <MASK> organization.	nonprofit
the company is a <MASK> organization.	nonprofit
the society is a <MASK> organization.	nonprofit
leader dogs is a <MASK> organization.	nonprofit
ukrpryroda is a <MASK> organization.	nonprofit
is a japanese advertising <MASK>.	agency
osha is a regulatory <MASK>.	agency
a day when a team does not have a <MASK> scheduled.	game
ranger is not a traditional board <MASK>.	game
life is not a board <MASK>.	game
safari is a web <MASK>.	browser
firefox is a web <MASK>.	browser
jeanne is a successful <MASK> chef.	pastry
rote grütze is a popular <MASK>.	dessert
coffee is a widely consumed <MASK>.	beverage
pomegranate juice is a popular <MASK>.	beverage
drinko is a lebanese <MASK> manufacturer.	beverage
the two <MASK> have a similar title page.	books
hardcover <MASK> have a stiff binding.	books
others argue that film <MASK> is not a genre.	noir
decoy is a 1946 american film <MASK>.	noir
deadly duo is a 1962 neo <MASK> film.	noir
love letters is a 1945 american film <MASK>.	noir
is a solution of a least <MASK> problem.	squares
that have a finite sum of <MASK> .	squares
a  is a row of <MASK> on the chessboard.	squares
is a teenage girl with <MASK> of an eating disorder.	symptoms
there is a wide range of <MASK> that patients show.	symptoms
wolfgang fink is a german <MASK> physicist.	theoretical
grc is a <MASK> of slm.	subsidiary
<MASK> is a prominent greenhouse gas.	methane
<MASK> is a powerful greenhouse gas.	methane
the official supporters have a club house beneath the east <MASK>.	stand
tyranids have a preference for <MASK> combat.	melee
the <MASK> critz house is a ca.	jacob
in his 1999 <MASK> have a nice day!	autobiography
the <MASK> is capable of accepting any type of aircraft.	airport
the <MASK> will also have a pilot training school.	airport
the <MASK> does not have a control tower.	airport
eae have a hangar at the <MASK>.	airport
the <MASK> does not have a control tower.	airport
the <MASK> is capable of accommodating the a380.	airport
the <MASK> is capable of operating atr aircraft.	airport
the <MASK> will initially have a single paved runway.	airport
is a retired japanese <MASK> racehorse.	thoroughbred
duncan is a <MASK> racehorse.	thoroughbred
ice box is a <MASK> racehorse.	thoroughbred
rebecca sharp is a <MASK> racehorse.	thoroughbred
hightail is a retired <MASK> racehorse.	thoroughbred
sinister minister is a <MASK> race horse.	thoroughbred
henny hughes is a <MASK> race horse.	thoroughbred
keen hunter is a <MASK> racehorse.	thoroughbred
gatewood is a <MASK> racehorse.	thoroughbred
the two highways have a <MASK> concurrency.	short
there is a <MASK> afterword.	short
vowels have a <MASK> and long form.	short
is a comics <MASK> edited by monte beauchamp.	anthology
fishermen must have a california <MASK> license.	fishing
a <MASK> pole does not have a reel.	fishing
a <MASK> pole does not have a reel.	fishing
do <MASK> have a higher sex drive?	women
do <MASK> have a higher sex drive?	women
unmarried <MASK> have a higher smoking rate.	women
<MASK> have a higher prevalence than men.	women
most <MASK> used to have a veil.	women
men have a better prognosis than <MASK>.	women
the <MASK> is not a member of fifa.	country
spanish is not a native language in that <MASK>.	country
but the <MASK> does not officially have a state religion.	country
amending the <MASK> is a complex process.	constitution
israel does not have a written <MASK>.	constitution
israel does not have a written <MASK>.	constitution
the new republic would have a <MASK>.	constitution
the <MASK> of mark does not have a commentary.	gospel
the <MASK> of mark does not have a commentary.	gospel
there is a time limit of six <MASK>.	hours
teachers have a 7 <MASK> and 35 minutes work day.	hours
the speaker does not have a vote in <MASK>.	parliament
west france is a european <MASK> constituency.	parliament
the speaker does not have a vote in <MASK>.	parliament
aptn is a <MASK> enterprise.	private
most doctors working in hospitals also have a <MASK> practice.	private
many public highways in the uk have a <MASK> owner.	private
saber is a <MASK> rifle chambered for .	sniper
chloe is not a naughty <MASK>!	girl
ananya is a beautiful <MASK>.	girl
the land use is a mix of cropping and <MASK>.	grazing
some services have a <MASK> of open and closed buses.	mixture
the legs have a <MASK> of black and reddish fur.	mixture
some verbs have a <MASK> of strong and weak forms.	mixture
astragalin is a chemical <MASK>.	compound
tricin is a chemical <MASK>.	compound
there is a regional hospital with 168 <MASK>.	beds
the hospital was designed to have a capacity of 1300 <MASK>.	beds
small community hospitals have a capacity of 10 to 30 <MASK>.	beds
medium community hospitals have a capacity of 60 <MASK>.	beds
maria is a talented <MASK>.	pianist
is a japanese classical <MASK>.	pianist
isabel is a concert <MASK>.	pianist
rentaro is a prodigy <MASK>.	pianist
is a 1959 album by jazz <MASK> jimmy smith.	organist
“homenaje a van <MASK>”.	gogh
theo van <MASK> .	gogh
the <MASK> does not have a school.	village
the <MASK> have a primary marathi school.	village
the <MASK> does not have a public library.	village
nevertheless the <MASK> does have a history.	village
the <MASK> does not have a school.	village
most towns and <MASK> have a folkpark.	cities
the <MASK> does not have a high school.	town
the <MASK> does not have a high school.	town
ethelton is a residential <MASK>.	suburb
waima is a <MASK> of auckland.	suburb
erskineville is a residential <MASK>.	suburb
taarbæk is a copenhagen <MASK>.	suburb
is a cheaper <MASK> to .	alternative
the mallets have a 25 <MASK> long stick.	cm
nucleocapsids have a <MASK> of 13.	diameter
the wheels have a <MASK> of .	diameter
both fairings have a <MASK> of 4.	diameter
the mounds sometimes have a <MASK> of .	diameter
the fruit is a small nutlet  in <MASK>.	diameter
flowers have a <MASK> of approximately .	diameter
the option was not <MASK>.	exercised
several queens <MASK> regal authority.	exercised
the title character is a beautiful international <MASK> thief.	jewel
that racetrack is a crown <MASK> of wilkes county .	jewel
the peninsula is a plateau threaded by river <MASK>.	valleys
nearly all communities have a local <MASK> council.	community
the <MASK> is capable of 3d editing.	software
since  is a constant in newtonian <MASK>.	mechanics
is a japanese plasma <MASK>.	physicist
lockyer is a particle <MASK>.	physicist
eberhard bodenschatz is a german <MASK>.	physicist
sullivan is a cell <MASK>.	biologist
is a japanese molecular <MASK>.	biologist
gough is a cell <MASK>.	biologist
the double cluster is a favorite of amateur <MASK>.	astronomers
mayan <MASK> discover an 18.	astronomers
the <MASK> is a popular folk instrument.	fiddle
from 2013 onward the band does not have a <MASK> player.	bass
from 2013 onward the band does not have a <MASK> player.	bass
crusade is a super <MASK> bros.	smash
the following is a list of pacific <MASK> seasons.	typhoon
cruisers <MASK> using paper charts and radar.	navigate
the classroom <MASK> have a total of 74 classrooms.	buildings
some <MASK> have a higher main floor.	buildings
all <MASK> have a distinctive flat roof design.	buildings
the station <MASK> have a high level of integrity.	buildings
all of the following <MASK> have a stuccoed exterior.	buildings
alex is a deputy district <MASK>.	attorney
weld is a prosecuting <MASK>.	attorney
the <MASK> groups in south africa have a variety of origins.	ethnic
the small islands now have a mixture of different <MASK> groups.	ethnic
is a fan of 1980s <MASK> punk.	hardcore
is a japanese <MASK> driver.	rally
his favorite drink is a gin and <MASK>.	tonic
gin and <MASK> is a popular cocktail during the summer.	tonic
the court <MASK> maryland.	upheld
common marmosets have a <MASK> mating system.	complex
molten <MASK> have a variety of uses.	salts
phbv is a thermoplastic <MASK>.	polymer
<MASK> barnes is a lawyer.	david
<MASK> john carson is a climatologist.	david
<MASK> riches is a british anatomist.	david
han is a fortune <MASK> of western horoscopes.	teller
the area is a largely <MASK> plateau.	forested
the church holds that <MASK> is a deviation.	homosexuality
elwood is a <MASK> and solicitor.	barrister
but the actions of the police and <MASK> did not have a clear plan.	prosecutors
bowness is a qualified <MASK> and notary public.	solicitor
elwood is a barrister and <MASK>.	solicitor
the house is not a pure example of any <MASK> style.	architectural
the dome seems to have a persian <MASK> influence.	architectural
is a japanese architect and <MASK> historian.	architectural
the bhuyans have a mixed <MASK> of deities.	pantheon
the <MASK> in rome is a famous rotunda.	pantheon
fam107b is a gene found in <MASK>.	humans
fam188a is a protein found in <MASK>.	humans
toll <MASK> in europe have a long history.	roads
kodukulanji is a junction of two <MASK>.	roads
gloddaeth in wales may have a similar <MASK>.	etymology
there is a folk <MASK> for the name as well.	etymology
